07 13 14 00 00 00 00 00 00 00 00 00 00 00 00 00 00 00 00 00
02 02 02 02 02 02 02 02 02 02 02 02 02 02 02 02 02 02 02 02
02 00 00 00 00 01 00 00 00 00 00 00 00 00 00 00 00 00 00 02
02 00 00 00 02 02 02 02 02 00 02 02 00 00 00 00 00 00 00 02
02 00 01 00 00 00 00 00 00 00 00 00 00 00 00 00 00 00 00 02
02 00 00 00 00 00 00 00 00 00 00 00 00 00 00 00 00 00 00 02
02 00 00 00 00 00 00 02 02 02 00 00 00 00 00 00 00 00 00 02
02 02 02 02 02 02 02 02 02 02 02 02 02 02 02 02 02 02 02 02