13 13 13 13 13 13 13 13 13 13 13
13 .. .. .. .. .. .. .. .. .. 13
13 .. .. .. .. .. .. .. .. .. 13
13 .. .. .. .. .. .. .. .. .. 13
13 .. .. .. .. .. .. .. .. .. 13
13 .. 18 .. .. .. .. .. .. .. 13
13 .. .. .. .. .. .. .. .. .. 13
13 .. .. .. .. .. .. .. .. .. 13
13 13 13 13 13 13 13 13 13 13 13
.. .. .. .. .. .. .. .. .. .. ..
.. 00 06 07 .. .. .. .. .. .. ..
.. 01 06 12 .. .. .. .. .. .. ..
.. .. .. .. .. .. .. .. .. .. ..